1111111111111111111111111
1m00000000000000000000001
1001111111111111111111101
1001000000000000000100001
1001011111111111111101111
1001000000000000000001001
1001010111111111111101001
1001010100000000000001001
1001110101111111111111101
1001000101000000010000001
1001101100011111000111111
10000001010000000100000e1
1111111111111111111111111
